AF      :    Afrikaans
AK      :    Akan
SQ      :    Albanian
AM     :    Amharic
AR      :   Arabic
HY       :   Armenian
AZ      :    Azerbaijani
EU       :   Basque
BE      :    Belarusian
BEM      :   Bemba
BN       :   Bengali
BH       :   Bihari
XX-BORK  :   Bork, bork, bork!
BS       :   Bosnian
BR       :   Breton
BG       :   Bulgarian
KM        :  Cambodian
CA        :  Catalan
CHR       :  Cherokee
NY         : Chichewa
ZH-CN      : Chinese (Simplified)
ZH-TW     :  Chinese (Traditional)
CO        :  Corsican
HR        :  Croatian
CS        :  Czech
DA        :  Danish
NL       :  Dutch
XX-ELMER  :  Elmer Fudd
EN       :   English
EO       :   Esperanto
ET        :  Estonian
EE        :  Ewe
FO       :   Faroese
TL       :   Filipino
FI       :   Finnish
FR       :   French
FY        :  Frisian
GAA      :   Ga
GL        :  Galician
KA       :   Georgian
DE        :  German
EL       :   Greek
GN        :  Guarani
GU        :  Gujarati
XX-HACKER :  Hacker
HT        :  Haitian Creole
HA        :  Hausa
HAW       :  Hawaiian
IW      :    Hebrew
HI      :    Hindi
HU       :   Hungarian
IS       :   Icelandic
IG      :    Igbo
ID      :    Indonesian
IA       :   Interlingua
GA      :    Irish
IT       :   Italian
JA      :    Japanese
JW      :    Javanese
KN      :    Kannada
KK       :   Kazakh
RW      :    Kinyarwanda
RN       :   Kirundi
XX-KLINGON : Klingon
KG       :   Kongo
KO        :  Korean
KRI      :   Krio (Sierra Leone)
KU       :   Kurdish
CKB      :   Kurdish (Soranî)
KY       :   Kyrgyz
LO        :  Laothian
LA       :   Latin
LV       :   Latvian
LN        :  Lingala
LT        :  Lithuanian
LOZ      :   Lozi
LG        :  Luganda
ACH      :   Luo
MK       :   Macedonian
MG       :   Malagasy
MS        :  Malay
ML        :  Malayalam
MT       :   Maltese
MI       :   Maori
MR       :   Marathi
MFE      :   Mauritian Creole
MO       :   Moldavian
MN       :   Mongolian
SR-ME    :   Montenegrin
NE       :   Nepali
PCM     :   Nigerian Pidgin
NSO      :   Northern Sotho
NO       :   Norwegian
NN       :   Norwegian (Nynorsk)
OC       :   Occitan
OR        :  Oriya
OM       :   Oromo
PS       :   Pashto
FA       :   Persian
XX-PIRATE :  Pirate
PL        :  Polish
PT-BR   :    Portuguese (Brazil)
PT-PT    :   Portuguese (Portugal)
PA      :    Punjabi
QU       :   Quechua
RO        :  Romanian
RM       :   Romansh
NYN     :   Runyakitara
RU        :  Russian
GD       :   Scots Gaelic
SR       :   Serbian
SH       :   Serbo-Croatian
ST       :   Sesotho
TN       :   Setswana
CRS      :   Seychellois Creole
SN       :   Shona
SD       :   Sindhi
SI       :   Sinhalese
SK       :   Slovak
SL       :   Slovenian
SO       :   Somali
ES       :   Spanish
ES-419   :   Spanish (Latin American)
SU      :    Sundanese
SW      :    Swahili
SV      :    Swedish
TG      :    Tajik
TA      :    Tamil
TT      :    Tatar
TE      :    Telugu
TH      :    Thai
TI      :    Tigrinya
TO      :    Tonga
LUA     :    Tshiluba
TUM      :   Tumbuka
TR      :    Turkish
TK      :    Turkmen
TW      :    Twi
UG      :    Uighur
UK      :    Ukrainian
UR       :   Urdu
UZ      :    Uzbek
VI      :    Vietnamese
CY      :    Welsh
WO       :   Wolof
XH      :    Xhosa
YI      :    Yiddish
YO       :   Yoruba
ZU      :    Zulu